11111111111111111111111111111111
11............................11
1.......................M......1
1.....C........1111............1
1..............................1
1.......11111..................1
1..............U...............1
1...11111......................1
1................C.............1
1..................11111.......1
1..............................1
1..............11..........C...1
1..............11..............1
1..P.....11....................1
1..............................1
1...................C..........1
1....1111......................1
1..............................1
1..................11111.......1
1..............................1
1....1111......................1
1..........C...................1
11............................11
11111111111111111111111111111111